NO texture_north.xpm
SO texture_south.xpm
WE texture_west.xpm
EA texture_east.xpm

F 72,111,56
C 130,200,229

111111111111
10000S000001
100000000001
100000000001
100000000001
100000100001
100001000001
100010000001
111111111111