NO textures/dungeon_north.xpm
SO textures/dungeon_south.xpm
WE textures/dungeon_west.xpm
EA textures/dungeon_east.xpm

F 50,40,30
C 40,40,50

111111111111111111
1E0000000000000001
100100000000000001
100000000000000001
111111111111111111
