NO texture_north.xpm
SO texture_south.xpm
WE texture_west.xpm
EA texture_east.xpm

F 72,111,56
C 130,200,229

111111111111111111
1E0000000000000001
100100000000000001
100000000000000001
111111111111111111
