NO textures/dungeon_north.xpm
SO textures/dungeon_south.xpm
WE textures/dungeon_west.xpm
EA textures/dungeon_east.xpm

F 50,40,30
C 40,40,50

11111111111111111111
1E000000100000000001
10111101010111111001
10000101010000001001
11110101011111101001
10000100000000101001
10111111111110101001
10000000000000101001
10111111111110101001
10000000010000100001
11111111111111111111